Y,3,1,2,2
Y,2,2,3,3
Y,3,3,2,4
Y,2,4,1,5
W,1,5,2,6
W,2,6,3,6
W,3,6,4,6
W,4,6,5,6
W,5,6,5,5
W,5,5,5,4
W,5,4,5,3
W,5,4,5,2
W,5,2,4,1
W,4,1,3,1
B,5,3,5,4
B,5,4,4,4
B,4,4,4,3
B,4,3,5,3
P,3,1,3,2
P,3,2,3,3
P,3,3,3,4
P,3,4,3,5
P,3,5,3,6
G,3,2
G,4,3
G,3,5
R,3,4
R,2,5
L,4,5,S