L,5,5,N
W,5,3,4,4
W,4,4,3,5
Y,3,5,3,6
Y,3,6,3,7
Y,3,7,3,8
Y,3,8,4,9

W,5,9,6,9
W,6,9,6,8
W,6,8,6,7
W,6,7,6,6
W,6,6,5,6
W,5,6,6,5
W,6,5,7,6
W,7,6,8,6
W,8,6,8,5
W,8,5,8,4
W,8,4,7,3
W,7,3,6,3
W,6,3,5,3
B,4,7,4,8
B,4,8,5,8
B,5,8,5,7
B,5,7,4,7
P,5,9,5,8
P,5,8,5,7
P,5,7,5,6
P,5,6,5,5
P,5,5,5,4
P,5,4,5,3
G,7,5
G,6,4
G,4,6
R,4,8
R,5,7
