W,0,1,1,0
W,0,1,0,2
W,0,2,0,3
W,0,3,0,4
W,0,4,0,5
W,1,0,2,0
W,2,0,3,0
W,3,0,3,1
Y,3,1,2,2
Y,2,2,3,3
Y,3,3,2,4
Y,2,4,1,5
W,0,5,1,5
B,0,2,1,2
B,1,2,1,3
B,1,3,0,3
B,0,3,0,2
P,1,0,1,1
P,1,1,1,2
P,1,2,2,3
P,2,3,1,4
P,1,4,0,5
G,1,1
G,1,3
G,2,3
R,2,1
R,1,4
L,1,1,N